{
  "tileMap": [
    [120, 100, 100, 100, 100, 100, 100, 100, 100, 100, 121, 100, 100, 100, 100, 100, 100, 100, 100, 100, 100, 100, 100, 100, 100, 100, 100, 100, 100, 100, 100, 121],
    [252, 198, 198, 198, 7, 198, 198, 198, 198, 198, 32, 198, 198, 198, 198, 198, 198, 198, 198, 198, 198, 198, 198, 198, 198, 7, 198, 198, 198, 198, 198, 251],
    [252, 198, 198, 198, 32, 198, 198, 198, 198, 198, 32, 9, 9, 9, 9, 198, 198, 198, 198, 198, 198, 198, 198, 198, 198, 32, 198, 198, 198, 34, 198, 251],
    [252, 198, 198, 198, 32, 198, 198, 198, 198, 198, 198, 198, 198, 198, 198, 198, 198, 198, 198, 32, 9, 9, 9, 198, 198, 32, 198, 198, 198, 34, 198, 251],
    [252, 198, 198, 198, 32, 198, 198, 198, 198, 198, 198, 198, 198, 198, 198, 198, 198, 198, 198, 198, 198, 198, 198, 198, 198, 32, 198, 198, 25, 25, 198, 251],
    [252, 198, 198, 198, 32, 198, 198, 198, 198, 198, 198, 57, 57, 57, 57, 7, 198, 198, 198, 198, 198, 198, 198, 198, 198, 32, 198, 198, 198, 198, 198, 251],
    [252, 198, 198, 57, 57, 57, 57, 198, 32, 198, 198, 198, 198, 201, 198, 32, 198, 198, 57, 57, 7, 198, 198, 57, 57, 57, 57, 7, 198, 198, 198, 251],
    [252, 198, 220, 220, 198, 198, 198, 198, 32, 198, 198, 6, 7, 201, 198, 32, 198, 198, 198, 198, 32, 198, 198, 198, 198, 198, 198, 32, 198, 198, 198, 251],
    [252, 198, 220, 220, 198, 198, 198, 198, 32, 198, 198, 30, 31, 201, 198, 32, 198, 198, 198, 198, 32, 198, 198, 198, 6, 7, 198, 32, 198, 198, 198, 251],
    [252, 198, 220, 220, 198, 198, 198, 198, 32, 198, 198, 198, 198, 201, 198, 32, 198, 198, 198, 198, 32, 198, 198, 198, 30, 31, 198, 32, 198, 198, 198, 251],
    [252, 198, 220, 220, 9, 9, 9, 9, 32, 198, 198, 198, 198, 201, 198, 32, 198, 198, 198, 198, 32, 198, 198, 198, 198, 198, 198, 32, 198, 198, 198, 251],
    [252, 198, 220, 220, 198, 198, 198, 32, 57, 57, 57, 57, 198, 201, 198, 198, 198, 198, 198, 57, 57, 198, 198, 177, 177, 177, 177, 32, 198, 198, 198, 251],
    [252, 198, 220, 220, 198, 198, 198, 32, 198, 198, 198, 198, 198, 198, 198, 198, 198, 198, 198, 198, 198, 198, 198, 6, 57, 57, 57, 57, 198, 198, 198, 251],
    [252, 198, 220, 220, 198, 198, 198, 32, 198, 198, 198, 9, 9, 9, 9, 9, 9, 9, 9, 9, 9, 198, 198, 198, 198, 198, 198, 198, 198, 198, 198, 251],
    [252, 198, 220, 220, 198, 198, 198, 198, 198, 198, 198, 198, 198, 198, 198, 198, 198, 177, 198, 198, 198, 198, 198, 198, 198, 198, 198, 198, 198, 198, 198, 251],
    [144, 76, 76, 76, 76, 76, 76, 76, 76, 76, 76, 76, 76, 76, 76, 76, 76, 76, 76, 76, 76, 76, 76, 76, 76, 76, 76, 76, 76, 76, 76, 145]
  ]
}