{
  "tileMap": [
    [149, 173, 173, 173, 173, 173, 173, 173, 173, 173, 173, 173, 173, 173, 173, 173, 173, 173, 173, 173, 173, 173, 173, 173, 173, 173, 173, 173, 173, 173, 173, 173, 173, 173, 173, 173, 173, 173, 173, 173, 173, 173, 173, 173, 173, 173, 173, 173, 173, 173, 173, 173, 173, 173, 173, 173, 173, 173, 173, 173, 173, 173, 173, 148],
    [147, 0, 55, 0, 0, 0, 0, 0, 0, 0, 0, 0, 0, 0, 0, 0, 0, 0, 0, 0, 0, 0, 0, 0, 0, 0, 0, 0, 0, 0, 0, 0, 0, 0, 0, 0, 0, 0, 0, 0, 0, 0, 0, 0, 0, 0, 0, 0, 0, 0, 0, 0, 0, 0, 0, 0, 0, 0, 0, 0, 0, 0, 0, 145],
    [147, 0, 0, 0, 0, 0, 0, 0, 0, 0, 0, 0, 0, 0, 0, 0, 0, 0, 0, 0, 0, 0, 0, 0, 0, 0, 0, 0, 0, 0, 0, 0, 0, 0, 0, 10, 11, 11, 11, 12, 0, 0, 0, 0, 0, 0, 0, 0, 0, 0, 0, 0, 0, 0, 0, 0, 0, 0, 0, 0, 0, 0, 0, 145],
    [147, 0, 0, 0, 55, 0, 0, 0, 0, 0, 0, 0, 0, 0, 0, 0, 0, 0, 0, 0, 0, 0, 0, 0, 0, 0, 0, 0, 0, 0, 0, 0, 10, 11, 11, 35, 35, 35, 35, 35, 11, 12, 0, 0, 0, 0, 0, 0, 28, 0, 0, 0, 0, 0, 0, 0, 0, 0, 0, 0, 0, 0, 0, 145],
    [147, 0, 0, 0, 0, 0, 0, 0, 0, 23, 23, 23, 24, 0, 0, 0, 0, 0, 2, 55, 0, 0, 0, 0, 0, 0, 0, 0, 0, 0, 0, 10, 35, 35, 35, 35, 35, 35, 35, 35, 35, 38, 12, 0, 0, 0, 0, 0, 0, 0, 0, 0, 0, 0, 0, 0, 0, 28, 0, 0, 0, 0, 0, 145],
    [147, 0, 0, 0, 0, 0, 0, 0, 0, 49, 50, 50, 26, 0, 0, 0, 0, 0, 0, 0, 0, 0, 0, 0, 0, 55, 0, 0, 0, 0, 0, 37, 35, 35, 35, 35, 35, 35, 35, 35, 35, 35, 38, 12, 0, 0, 0, 0, 0, 0, 0, 0, 0, 0, 0, 0, 0, 0, 0, 0, 0, 0, 0, 145],
    [147, 0, 0, 0, 0, 0, 0, 0, 0, 49, 50, 50, 53, 0, 0, 0, 0, 0, 0, 0, 0, 0, 0, 0, 0, 55, 0, 0, 0, 56, 0, 37, 35, 35, 35, 35, 35, 35, 35, 35, 35, 35, 35, 39, 0, 0, 0, 0, 0, 0, 0, 0, 0, 0, 0, 0, 0, 0, 0, 0, 0, 0, 0, 145],
    [147, 0, 0, 0, 0, 0, 0, 0, 0, 49, 50, 50, 80, 26, 0, 0, 0, 2, 0, 0, 0, 0, 0, 0, 0, 0, 0, 0, 0, 0, 0, 37, 35, 35, 35, 35, 35, 35, 35, 35, 35, 35, 35, 39, 0, 0, 0, 1, 0, 0, 0, 0, 0, 0, 0, 0, 0, 0, 0, 0, 0, 0, 0, 145],
    [147, 0, 0, 0, 0, 0, 0, 0, 0, 49, 50, 50, 50, 50, 26, 26, 26, 0, 0, 0, 0, 0, 55, 0, 0, 0, 0, 0, 2, 0, 0, 37, 35, 35, 35, 35, 35, 35, 35, 35, 35, 35, 35, 39, 0, 0, 27, 0, 0, 0, 0, 0, 0, 0, 1, 1, 0, 0, 0, 0, 0, 0, 0, 145],
    [147, 0, 0, 0, 0, 0, 29, 28, 0, 28, 50, 50, 50, 50, 50, 50, 50, 0, 0, 0, 0, 0, 0, 0, 0, 0, 0, 0, 0, 0, 0, 37, 35, 35, 35, 35, 35, 35, 35, 35, 35, 35, 35, 39, 0, 0, 54, 0, 0, 0, 0, 0, 0, 27, 0, 0, 0, 0, 0, 0, 0, 0, 0, 145],
    [147, 0, 0, 0, 0, 0, 0, 0, 22, 50, 50, 50, 50, 50, 50, 50, 50, 0, 0, 0, 0, 0, 0, 0, 0, 29, 0, 0, 0, 0, 0, 37, 35, 35, 35, 35, 35, 35, 35, 35, 35, 35, 38, 66, 0, 0, 1, 0, 0, 0, 0, 0, 0, 0, 55, 0, 0, 0, 0, 0, 0, 0, 0, 145],
    [147, 0, 0, 0, 0, 0, 0, 0, 49, 50, 50, 50, 50, 50, 50, 50, 50, 0, 0, 0, 0, 0, 0, 2, 0, 0, 0, 0, 0, 0, 55, 64, 38, 35, 35, 35, 35, 35, 35, 35, 65, 65, 66, 0, 0, 27, 28, 29, 27, 28, 29, 0, 0, 0, 0, 0, 0, 0, 0, 0, 0, 0, 0, 145],
    [147, 0, 0, 0, 0, 0, 0, 0, 49, 50, 50, 50, 50, 50, 50, 50, 50, 0, 0, 0, 0, 0, 0, 0, 0, 0, 0, 0, 0, 0, 0, 55, 64, 65, 65, 65, 65, 65, 65, 66, 0, 0, 0, 0, 0, 54, 55, 56, 54, 0, 1, 2, 0, 0, 0, 0, 0, 0, 0, 0, 0, 0, 0, 145],
    [147, 0, 0, 0, 0, 0, 0, 0, 49, 50, 50, 50, 50, 50, 50, 50, 50, 28, 0, 0, 0, 0, 0, 0, 0, 0, 0, 0, 0, 0, 0, 0, 0, 0, 0, 0, 0, 0, 0, 0, 0, 0, 0, 0, 0, 0, 0, 0, 0, 27, 0, 29, 0, 0, 2, 0, 0, 0, 0, 0, 0, 0, 0, 145],
    [147, 0, 0, 0, 0, 0, 0, 22, 50, 50, 50, 50, 50, 50, 50, 50, 50, 0, 0, 0, 0, 0, 0, 0, 0, 0, 0, 0, 0, 0, 0, 0, 0, 0, 0, 0, 0, 0, 0, 0, 0, 0, 0, 0, 0, 0, 0, 0, 0, 0, 55, 56, 27, 28, 29, 0, 0, 0, 0, 0, 0, 0, 0, 145],
    [147, 0, 0, 0, 0, 0, 0, 49, 50, 53, 50, 50, 50, 50, 50, 50, 50, 0, 0, 0, 0, 0, 0, 28, 0, 0, 0, 2, 2, 0, 0, 0, 0, 0, 0, 0, 0, 0, 0, 0, 86, 87, 87, 87, 87, 87, 87, 87, 88, 0, 0, 0, 54, 55, 56, 0, 0, 0, 0, 0, 0, 0, 0, 145],
    [147, 0, 0, 0, 0, 0, 0, 49, 50, 50, 50, 50, 50, 50, 50, 50, 50, 11, 11, 12, 0, 0, 0, 28, 0, 0, 0, 0, 0, 0, 0, 0, 0, 0, 0, 0, 0, 86, 87, 87, 89, 114, 114, 114, 114, 114, 114, 114, 90, 88, 0, 0, 55, 0, 0, 0, 0, 0, 0, 0, 0, 0, 0, 145],
    [147, 0, 0, 0, 0, 0, 0, 49, 50, 50, 50, 50, 50, 50, 50, 50, 50, 38, 38, 39, 0, 29, 0, 0, 0, 0, 0, 0, 0, 0, 0, 55, 0, 0, 0, 29, 86, 89, 114, 114, 114, 114, 114, 114, 114, 114, 114, 114, 114, 115, 0, 0, 0, 0, 0, 0, 0, 0, 0, 0, 0, 0, 0, 145],
    [147, 0, 0, 0, 0, 0, 0, 49, 50, 50, 50, 50, 50, 50, 50, 50, 38, 38, 38, 39, 0, 0, 0, 0, 0, 0, 0, 0, 0, 86, 87, 87, 87, 87, 87, 87, 89, 114, 114, 114, 114, 114, 114, 114, 114, 114, 114, 114, 114, 90, 88, 0, 0, 0, 0, 0, 0, 0, 0, 0, 0, 0, 0, 145],
    [147, 0, 0, 0, 0, 0, 0, 49, 50, 50, 50, 50, 77, 77, 77, 65, 65, 65, 65, 66, 0, 0, 0, 0, 0, 0, 0, 0, 0, 113, 114, 114, 114, 114, 114, 114, 114, 114, 114, 114, 114, 114, 114, 114, 114, 114, 114, 114, 114, 114, 115, 0, 55, 0, 0, 0, 0, 0, 0, 0, 0, 0, 0, 145],
    [147, 0, 0, 0, 0, 0, 0, 49, 50, 50, 50, 78, 0, 0, 0, 0, 0, 0, 0, 0, 0, 0, 0, 0, 0, 0, 0, 0, 0, 113, 114, 114, 114, 114, 114, 114, 114, 114, 114, 114, 114, 114, 114, 114, 114, 114, 114, 114, 114, 114, 115, 0, 55, 0, 0, 0, 0, 0, 0, 0, 0, 0, 0, 145],
    [147, 0, 0, 0, 55, 0, 0, 49, 50, 50, 51, 0, 0, 0, 28, 28, 0, 0, 0, 0, 0, 0, 0, 0, 0, 0, 0, 0, 0, 113, 114, 114, 114, 114, 114, 114, 114, 114, 114, 114, 114, 114, 114, 114, 114, 114, 114, 114, 114, 114, 115, 0, 0, 28, 0, 0, 0, 0, 0, 0, 0, 0, 0, 145],
    [147, 0, 0, 0, 0, 0, 0, 76, 77, 77, 78, 0, 0, 0, 0, 0, 0, 0, 0, 0, 0, 0, 0, 0, 0, 0, 0, 0, 0, 113, 114, 114, 114, 114, 114, 114, 114, 114, 114, 114, 114, 114, 114, 114, 114, 114, 114, 114, 114, 114, 115, 0, 0, 0, 0, 0, 0, 0, 0, 0, 0, 0, 0, 145],
    [147, 0, 0, 0, 0, 0, 0, 0, 0, 0, 0, 0, 0, 0, 86, 87, 87, 88, 0, 0, 0, 55, 0, 0, 0, 0, 0, 0, 0, 113, 114, 114, 114, 114, 114, 114, 114, 114, 114, 114, 114, 114, 114, 114, 114, 114, 114, 114, 114, 114, 115, 0, 0, 0, 0, 0, 0, 0, 0, 0, 0, 0, 0, 145],
    [147, 0, 0, 0, 0, 0, 0, 0, 0, 0, 0, 0, 0, 0, 113, 114, 114, 90, 88, 28, 29, 0, 0, 0, 0, 0, 0, 0, 0, 140, 116, 114, 114, 114, 114, 114, 114, 114, 114, 114, 114, 114, 114, 114, 114, 114, 114, 114, 114, 117, 142, 0, 0, 0, 0, 0, 0, 0, 0, 0, 0, 0, 0, 145],
    [147, 0, 0, 0, 0, 0, 0, 0, 0, 0, 0, 0, 28, 0, 140, 116, 114, 114, 115, 28, 29, 29, 29, 0, 0, 0, 0, 0, 0, 0, 140, 116, 114, 114, 114, 114, 114, 114, 114, 114, 114, 114, 114, 114, 114, 114, 114, 117, 141, 142, 0, 0, 0, 0, 0, 0, 0, 0, 0, 0, 0, 0, 0, 145],
    [147, 0, 0, 0, 0, 0, 0, 0, 0, 0, 0, 0, 0, 0, 0, 140, 141, 141, 142, 28, 29, 29, 56, 29, 0, 0, 0, 0, 0, 0, 0, 140, 141, 116, 114, 114, 114, 114, 114, 114, 114, 114, 114, 114, 114, 114, 114, 142, 0, 0, 0, 0, 0, 0, 0, 0, 0, 55, 0, 0, 0, 0, 0, 145],
    [147, 0, 0, 0, 55, 0, 0, 0, 0, 0, 0, 0, 0, 0, 0, 28, 29, 28, 28, 55, 56, 29, 56, 56, 0, 0, 0, 0, 0, 0, 0, 0, 0, 140, 141, 116, 114, 114, 114, 114, 114, 114, 117, 141, 141, 141, 142, 55, 0, 0, 0, 0, 0, 0, 0, 0, 0, 0, 0, 0, 0, 0, 0, 145],
    [147, 0, 0, 0, 0, 0, 0, 0, 0, 0, 0, 0, 0, 0, 55, 55, 28, 55, 55, 56, 56, 29, 56, 56, 0, 0, 0, 0, 0, 0, 0, 28, 28, 0, 0, 140, 141, 116, 114, 114, 114, 141, 142, 0, 0, 0, 0, 0, 0, 0, 0, 0, 0, 0, 0, 0, 0, 0, 0, 0, 0, 0, 0, 145],
    [147, 0, 0, 0, 0, 0, 0, 0, 0, 0, 0, 28, 0, 0, 0, 55, 55, 56, 56, 56, 29, 56, 0, 0, 0, 0, 0, 0, 0, 0, 0, 0, 0, 0, 0, 0, 0, 140, 141, 141, 142, 0, 0, 0, 0, 0, 0, 0, 0, 0, 0, 0, 0, 0, 0, 0, 0, 0, 0, 0, 0, 0, 0, 145],
    [147, 0, 0, 0, 0, 0, 0, 0, 0, 0, 0, 0, 0, 0, 0, 0, 55, 56, 56, 56, 56, 29, 29, 0, 0, 0, 0, 0, 0, 0, 0, 0, 0, 0, 0, 0, 0, 0, 0, 0, 0, 0, 0, 0, 0, 0, 0, 0, 0, 0, 0, 0, 0, 0, 0, 0, 0, 0, 0, 0, 0, 0, 0, 145],
    [122, 119, 119, 119, 119, 119, 119, 119, 119, 119, 119, 119, 119, 119, 119, 119, 119, 119, 119, 119, 119, 119, 119, 119, 119, 119, 119, 119, 119, 119, 119, 119, 119, 119, 119, 119, 119, 119, 119, 119, 119, 119, 119, 119, 119, 119, 119, 119, 119, 119, 119, 119, 119, 119, 119, 119, 119, 119, 119, 119, 119, 119, 119, 121]
  ]
}